                                                                          
                                                                          
                                                                          
   #########                                                              
   #.......#    #########                                                 
   #.......######.......#                                                 
   #.......+....+.......#    ##################                           
   #.......######.......######*...............#                           
   #########    #.......+....+................#                           
                #.......######................#                           
                ###+#####    #................#    ############           
                  #.#        #................#    #..........#           
                  #.#        #................######..........#           
                  #.#        #................+....+..........#           
                  #.#        #................######..........#           
         ##########+##########................#    #..........#           
         #............+......+................#    #..........#           
         #............##################+######    #..........#           
         #............#                #.#         ############           
         #............#                #.#                               
         #............#             ####.######                           
         ##############             #.........#                           
                                    #.........#                           
                                    #.........#                           
                                    #.........#                           
                                    #.........#                           
                                    #.........#                           
                                    #.........#                           
                                    ###########                           
                                                                          
